#############n
#----#---f--#n
##m#-#m##-#-#n
#--#---#--#-#n
##-m-----##-#n
#-f--###-##-#n
#-#-#-r#f---#n
#-#-#-##-####n
#-#m#--#-#-##n
#--f-m---m--#n
###-####-##-#n
#----m---#--#n
#############d
