#############n
#----$---f--#n
#$m$-$m$$-$-#n
#--$---$--$-#n
#$-m-----$$-#n
#-f--$$$-$$-#n
#-$-$--$f---#n
#-$-$r$$-$$$#n
#-$m$--$-$-$#n
#--f-m---m--#n
#$$-$$$$-$$-#n
#----m---$--#n
#############d
